bedroom=[[0,0,4,0,2,3,41,83,82],
         [15,15,19,20,32,18,15,15,82],
         [15,15,45,46,15,15,15,15,82],
         [15,15,15,15,15,15,15,15,82],
         [40,15,15,15,30,31,15,15,82],
         [55,15,15,15,45,46,15,15,82],
         [82,82,82,82,82,82,82,82,82]]

bedroom_data=('bedroom',700,0)

downstairs=[[5,6,35,8,2,0,0,0,0,22,82],
         [33,34,50,8,62,63,15,15,15,15,82],
         [15,15,15,7,15,15,15,15,15,15,82],
         [15,15,15,0,16,60,61,16,15,15,82],
         [15,15,15,15,16,75,76,16,15,15,82],
         [15,15,15,15,15,45,46,15,15,15,82],
         [15,15,15,15,15,15,15,15,15,15,82],
         [15,15,15,15,15,15,21,21,15,15,82],
         [82,82,82,82,82,82,82,82,82,82,82]]

downstairs_data=('downstairs',900,0)
